11111111
1PEC10C1
1C0C00C1
11000111
11C10C01
1C000C01
11111111
