1111111111111
1E00000010001
10100101C1101
101001C010101
1P0000000C001
1111111111111