1111111111111
1E10000000001
11100101C0101
101001C010101
1P0000000C001
1111111111111