1111111111111111111111111111111111111111111111111111111111111
1000000000000000000000000000000000000000000000000000001111111
1000000000000000000000000000000000000000000000000000001111111
1000000000000000000000000000000000000000000000000000001111111
1000000000000000000000000000000000000000000000000000001111111
1000000000000000000000000000000000000000000000000000001111111
1000000000000000000000000000000000000000000000000000001111111
1000000000000000000000000000000000000000000000000000001111111
1000000000000000000000000000000000000000000000000000001111111
1000000000000000000000000000000000000000000000000000001111111
1000000000000000000000000000000000000000000000000000001111111
1000000000000000000000000000000000000000000000000000001111111
1000000000000000000000000000000000000000000000000000001111111
1000000000000000000000000000000000000000000000000000001111111
1000000000000000000000000000000000000000000000000000001111111
1000000000000000000000000000000000000000000000000000001111111
1000000000000000000000000000000000000000000000000000001111111
1000000000000000000000000000000000000000000000000000001111111
1000000000000000000000000000000000000000000000000000001111111
1000000000000000000000000000000000000000000000000000001111111
1000000000000000000000000000000000000000000000000000001111111
1000000000000000000000000000000000000000000000000000000111111
100000000000000000000000000000000000000000000C00E00P000111111
1000000000000000000000000000000000000000000000000000000011111
1000000000000000000000000000000000000000000000000000000011111
1000000000000000000000000000000000000000000000000000000011111
1000000000000000000000000000000000000000000000000000000011111
1000000000000000000000000000000000000000000000000000000011111
1100000000000000000000000000000000000000000000000000000001111
1000000000000000000000000000000000000000000000000000000011111
1000000000000000000000000000000000000000000000000000000001111
1000000000000000000000000000000000000000000000000000000001111
1111111111111111111111111111111111111111111111111111111111111
1111111111111111111111111111111111111111111111111111111111111