111111111111111111111111111111111111111111111111111111111111
1000000000000001E1111111111111111111111111111111111111111111
100000111100000101111111111111111111111111111111111111111111
100C00000C10000001111111111111111111111111111111111111111111
100000001111100001111111111111111111111111111111111111111111
111000000C00000111111111111111111111111111111111111111111111
1P00000C0000000101111111111111111111111111111111111111111111
111111111111111111111111111111111111111111111111111111111111
