1111111111111111111111111
1001000000011100000111111
1P00011111001000000100001
1000000000010000000100111
10C00C000C0000CCC00E0C001
1111111111111111111111111
